50,8
-------------------X-X----------------------------
--------------------X------X------XX------X-------
------X-----X-------X-X--------X-X---X------------
--------------------X-----XX---------------X----D-
-@--------XXX------------X-X------------X-X-X-----
-----X--X--------------------XX-----------X-------
-------------X-X-------X--------------X-----------
--------------------------------------------------
